000000000000000000000000000000
000000000000000000000000000000
000000000000000000000000000000
t00000000000000000000000000000
rt0000000000000000000000000000
art000000000000000000000000000
0art00000000000000000000000000
00art0000000000000000000000000
000rr0000000000000000000000000
000rr0000000000000000000000000
000rr0000000000000000000000000
00lrd0000000000000000000000000
0lrd00000000000000000000000000
lrd0000000000lrrrrrrt000000000
rd0000000000lrrrrrrrrt00000000
d0000000000lrd000000art0000000
0000000000lrd00000000art000000
000000000lrd0000000000art00000
00000000lrd000000000000art0000
0000000lrd00000000000000art000