000000000000000000000000000000
000000000000000000000000000000
000000000000000000000000000000
rrrrrrrrrrrrrrrrrrrrrrrrrrrrrr
rrrrrrrrrrrrrrrrrrrrrrrrrrrrrr
00000000000000000at000000ld000
000000000000000000at0000ld0000
0000000000000000000at00ld00000
00000000000000000000atld000000
000000000000000000000ah0000000
0000000000000000000000at000000
00000000000000000000000at00000
000000000000000000000000at0000
0000000000000000000000000at000
00000000000000000000000000at00
000000000000000000000000000at0
0000000000000000000000000000at
00000000000000000000000000000a
000000000000000000000000000000
000000000000000000000000000000