000000000000000000000000000000
t00000000000000000000000000000
rt0000000000000000000000000000
rrt000000000000000000000000000
rrrrrrrrrrrrrrrrrrrt0000000000
rrd0000000000lrd00art000000000
rr0000000000lrd0000art00000000
rr000000000lrd000000arrrrrrrrr
rrt0000000lrd0000000lrd0000000
rrrrrrrrrrrd0000000lrd00000000
rrd0art00000000000lrd000000000
rr000art000000000lrd0000000000
rr0000art0000000lrd00000000000
rr00000art00000lrd000000000000
rrt00000art000lrd0000000000000
rrrrrrrrrrrrrrrd00000000000000
rrrd00000000000000000000000000
rrr000000000000000000000000000
rrr000000000000000000000000000
rrr000000000000000000000000000